WWWWWWWWWW
W-------BW
WF--FW---W
W---FW--FW
WWWWW---FW
W----FF-WW
W-------FW
W--------W
W--------W
WWWWWWWWWW
(7,6)
(1,8)